"aa" = (/turf/unsimulated/wall/planetary/normal,/area/planets/Geminus/outdoor/vr/forest)
"ab" = (/turf/simulated/mineral/impassable,/area/planets/Geminus/outdoor/vr/forest)
"ac" = (/turf/simulated/floor/snow,/area/planets/Geminus/outdoor/vr/forest)
"ad" = (/obj/structure/flora/tree/dead,/turf/simulated/floor/snow,/area/planets/Geminus/outdoor/vr/forest)
"ae" = (/obj/structure/flora/tree/jungle_small,/turf/simulated/floor/snow,/area/planets/Geminus/outdoor/vr/forest)
"af" = (/obj/structure/flora/grass/brown,/turf/simulated/floor/snow,/area/planets/Geminus/outdoor/vr/forest)
"ag" = (/obj/structure/closet/statue,/turf/simulated/floor/snow,/area/planets/Geminus/outdoor/vr/forest)
"ah" = (/obj/structure/flora/tree/jungle,/turf/simulated/floor/snow,/area/planets/Geminus/outdoor/vr/forest)
"ai" = (/obj/item/weapon/nullrod,/turf/simulated/floor/snow,/area/planets/Geminus/outdoor/vr/forest)
"aj" = (/obj/structure/bonfire/permanent,/turf/simulated/floor/snow,/area/planets/Geminus/outdoor/vr/forest)
"ak" = (/obj/structure/flora/rock,/turf/simulated/floor/snow,/area/planets/Geminus/outdoor/vr/forest)
"al" = (/obj/structure/flora/grass/green,/turf/simulated/floor/snow,/area/planets/Geminus/outdoor/vr/forest)
"am" = (/obj/structure/loot_pile/VR/weapon,/turf/simulated/floor/snow,/area/planets/Geminus/outdoor/vr/forest)
"an" = (/mob/living/simple_animal/hostile/statue{banishable = 1; view_range = 15},/turf/simulated/floor/snow,/area/planets/Geminus/outdoor/vr/forest)
"ao" = (/obj/structure/flora/grass/both,/turf/simulated/floor/snow,/area/planets/Geminus/outdoor/vr/forest)
"ap" = (/obj/effect/landmark/virtual_reality{name = "Bosnian Caves: 2324 - Remastered"},/turf/simulated/floor/snow,/area/planets/Geminus/outdoor/vr/forest)
"aq" = (/obj/structure/loot_pile/VR/firstaid,/obj/structure/table/alien,/turf/simulated/floor/snow,/area/planets/Geminus/outdoor/vr/forest)
"ar" = (/obj/structure/table/alien,/turf/simulated/floor/snow,/area/planets/Geminus/outdoor/vr/forest)
"as" = (/turf/unsimulated/wall/planetary/normal,/area/planets/Geminus/outdoor/vr)
"at" = (/obj/structure/loot_pile/VR/light,/obj/structure/table/alien,/turf/simulated/floor/snow,/area/planets/Geminus/outdoor/vr/forest)
"au" = (/turf/simulated/mineral,/area/planets/Geminus/outdoor/vr)
"av" = (/turf/space,/area/space)
"aw" = (/turf/simulated/mineral/floor,/area/planets/Geminus/outdoor/vr)
"ax" = (/turf/simulated/floor/outdoors/grass,/area/planets/Geminus/outdoor/vr)
"ay" = (/turf/simulated/floor/outdoors/grass/forest,/area/planets/Geminus/outdoor/vr)
"az" = (/turf/simulated/floor/outdoors/grass/nogrowth,/area/planets/Geminus/outdoor/vr)
"aA" = (/turf/unsimulated/wall/planetary/normal,/area/space)
"aB" = (/obj/structure/loot_pile/VR/knife,/turf/simulated/mineral/floor,/area/planets/Geminus/outdoor/vr)
"aC" = (/obj/structure/loot_pile/VR/light,/turf/simulated/mineral/floor,/area/planets/Geminus/outdoor/vr)
"aD" = (/obj/effect/landmark/virtual_reality{name = "CaveCraft"},/obj/structure/bed,/turf/simulated/mineral/floor,/area/planets/Geminus/outdoor/vr)
"aE" = (/obj/structure/bonfire/permanent,/turf/simulated/mineral/floor,/area/planets/Geminus/outdoor/vr)
"aF" = (/turf/simulated/floor/water,/area/planets/Geminus/outdoor/vr)
"aG" = (/turf/simulated/floor/wood/ebony,/area/space)
"aH" = (/turf/simulated/wall/ebony,/area/space)
"aI" = (/turf/simulated/floor/carpet,/area/space)
"aJ" = (/obj/effect/decal/cleanable/ash,/turf/simulated/floor/wood/ebony,/area/space)
"aK" = (/obj/effect/decal/cleanable/cobweb2,/turf/simulated/floor/wood/ebony,/area/space)
"aL" = (/obj/structure/flora/pottedplant/thinbush,/turf/simulated/floor/wood/ebony,/area/space)
"aM" = (/obj/structure/flora/pottedplant/large,/turf/simulated/floor/wood/ebony,/area/space)
"aN" = (/obj/structure/simple_door/wood,/turf/simulated/floor/wood/ebony,/area/space)
"aO" = (/obj/effect/landmark/vr_spawner{key = 1; spawn_type = "/mob/living/simple_animal/shade"},/turf/simulated/floor/wood/ebony,/area/space)
"aP" = (/turf/simulated/floor/outdoors/grass/forest,/area/space)
"aQ" = (/obj/structure/flora/ausbushes/lavendergrass,/turf/simulated/floor/outdoors/grass/forest,/area/space)
"aR" = (/obj/structure/flora/ausbushes/ywflowers,/turf/simulated/floor/outdoors/grass/forest,/area/space)
"aS" = (/obj/structure/flora/ausbushes/lavendergrass,/turf/simulated/floor/outdoors/grass/forest/nogrowth,/area/space)
"aT" = (/turf/simulated/floor/outdoors/grass/forest/nogrowth,/area/space)
"aU" = (/obj/structure/flora/rock,/turf/simulated/floor/outdoors/grass/forest/nogrowth,/area/space)
"aV" = (/obj/structure/flora/pottedplant/shoot,/turf/simulated/floor/outdoors/grass/forest/nogrowth,/area/space)
"aW" = (/obj/effect/decal/cleanable/filth,/turf/simulated/floor/outdoors/mud,/area/space)
"aX" = (/turf/simulated/floor/outdoors/mud,/area/space)
"aY" = (/obj/structure/flora/ausbushes/brflowers,/turf/simulated/floor/outdoors/grass/forest/nogrowth,/area/space)
"aZ" = (/obj/structure/flora/ausbushes/fernybush,/turf/simulated/floor/outdoors/grass/forest,/area/space)
"ba" = (/obj/structure/flora/rock,/turf/simulated/floor/outdoors/grass/forest,/area/space)
"bb" = (/obj/structure/flora/ausbushes/fernybush,/turf/simulated/floor/outdoors/grass/forest/nogrowth,/area/space)
"bc" = (/turf/simulated/mineral/impassable,/area/space)
"bd" = (/turf/simulated/floor/wood/ebony{icon_state = "wood1"},/area/space)
"be" = (/obj/structure/simple_door/wood,/turf/simulated/floor/wood/ebony{icon_state = "wood2"},/area/space)
"bf" = (/obj/machinery/light/small{dir = 1},/turf/simulated/floor/wood/ebony,/area/space)
"bg" = (/obj/structure/flora/ausbushes/pointybush,/turf/simulated/floor/outdoors/grass/forest/nogrowth,/area/space)
"bh" = (/obj/structure/flora/ausbushes/pointybush,/turf/simulated/floor/outdoors/grass/forest,/area/space)
"bi" = (/obj/structure/flora/ausbushes/brflowers,/turf/simulated/floor/outdoors/grass/forest,/area/space)
"bj" = (/obj/structure/flora/ausbushes/ywflowers,/turf/simulated/floor/outdoors/grass/forest/nogrowth,/area/space)
"bk" = (/obj/machinery/light/small{dir = 1},/turf/simulated/floor/outdoors/grass/forest/nogrowth,/area/space)
"bl" = (/obj/structure/flora/ausbushes/lavendergrass,/turf/simulated/floor/outdoors/mud,/area/space)
"bm" = (/turf/simulated/floor/pavement/brick_paving,/area/space)
"bn" = (/obj/structure/simple_door/wood,/turf/simulated/floor/wood/ebony{icon_state = "wood1"},/area/space)
"bo" = (/obj/structure/bed/double/padded,/obj/effect/decal/remains/human{pixel_y = 12},/obj/effect/decal/remains/human,/obj/item/weapon/bedsheet/iandouble,/turf/simulated/floor/carpet,/area/space)
"bp" = (/turf/simulated/wall/silver,/area/space)
"bq" = (/obj/structure/coatrack,/turf/simulated/floor/carpet,/area/space)
"br" = (/obj/effect/landmark/virtual_reality{name = "Cursed Mansion: Part I"},/turf/simulated/floor/outdoors/mud,/area/space)
"bs" = (/obj/structure/coatrack,/turf/simulated/floor/wood/ebony,/area/space)
"bt" = (/obj/structure/mirror{pixel_y = 32},/turf/simulated/floor/wood/ebony,/area/space)
"bu" = (/obj/structure/loot_pile/VR/firstaid,/obj/structure/table/woodentable/walnut,/turf/simulated/floor/wood/ebony,/area/space)
"bv" = (/turf/simulated/floor/wood/ebony{icon_state = "wood2"},/area/space)
"bw" = (/obj/structure/loot_pile/VR/light,/obj/structure/table/woodentable/walnut,/turf/simulated/floor/wood/ebony,/area/space)
"bx" = (/obj/structure/table/woodentable/walnut,/turf/simulated/floor/wood/ebony,/area/space)
"by" = (/obj/structure/loot_pile/maint/technical,/turf/simulated/floor/wood/ebony,/area/space)
"bz" = (/obj/random/trash,/turf/simulated/floor/carpet,/area/space)
"bA" = (/obj/random/trash,/turf/simulated/floor/wood/ebony,/area/space)
"bB" = (/obj/structure/table/woodentable/walnut,/obj/structure/sink{dir = 4; icon_state = "sink"; pixel_x = 10},/turf/simulated/floor/wood/ebony,/area/space)
"bC" = (/obj/structure/toilet{icon_state = "toilet00"; dir = 4},/turf/simulated/floor/wood/ebony,/area/space)
"bD" = (/obj/structure/sink{dir = 4; icon_state = "sink"; pixel_x = 10},/turf/simulated/floor/wood/ebony,/area/space)
"bE" = (/obj/machinery/door/blast/gate{icon_state = "shutter1"; dir = 2},/turf/simulated/floor/carpet,/area/space)
"bF" = (/obj/structure/loot_pile/maint/boxfort,/turf/simulated/floor/wood/ebony,/area/space)
"bG" = (/obj/effect/landmark/vr_spawner{key = 1; spawn_type = "/mob/living/simple_animal/shade"},/turf/simulated/floor/carpet,/area/space)
"bH" = (/obj/structure/table/woodentable/walnut,/obj/structure/loot_pile/VR/knife,/turf/simulated/floor/wood/ebony,/area/space)
"bI" = (/obj/item/weapon/flame/candle/candelabra,/obj/structure/table/woodentable/walnut,/turf/simulated/floor/wood/ebony,/area/space)
"bJ" = (/turf/simulated/floor/wood/ebony{icon_state = "wood3"},/area/space)
"bK" = (/obj/item/weapon/flame/candle/candelabra,/turf/simulated/floor/carpet,/area/space)
"bL" = (/obj/machinery/light/small{dir = 1},/turf/simulated/floor/wood/ebony{icon_state = "wood1"},/area/space)
"bM" = (/obj/structure/loot_pile/surface/bones,/turf/simulated/floor/wood/ebony,/area/space)
"bN" = (/obj/structure/closet/cabinet,/obj/item/weapon/bone/arm,/turf/simulated/floor/wood/ebony,/area/space)
"bO" = (/obj/structure/table/woodentable/walnut,/obj/item/weapon/bone/skull,/turf/simulated/floor/wood/ebony,/area/space)
"bP" = (/obj/structure/table/woodentable/walnut,/obj/item/weapon/cane,/turf/simulated/floor/wood/ebony,/area/space)
"bQ" = (/obj/structure/window/framed,/obj/structure/curtain/color/burgandy,/turf/simulated/floor/wood/ebony,/area/space)
"bR" = (/obj/structure/window/framed,/obj/structure/curtain/open/color/burgandy,/turf/simulated/floor/wood/ebony,/area/space)
"bS" = (/obj/item/tape/police{icon_state = "tape_door_1"},/obj/structure/simple_door/wood,/turf/simulated/floor/carpet,/area/space)
"bT" = (/obj/effect/decal/cleanable/dirt,/turf/simulated/wall/ebony,/area/space)
"bU" = (/obj/effect/wallframe_spawn/basic,/turf/simulated/floor/wood/ebony,/area/space)
"bV" = (/obj/structure/loot_pile/maint/boxfort,/turf/simulated/floor/outdoors/grass/forest,/area/space)
"bW" = (/obj/random/junk,/turf/simulated/floor/outdoors/grass/forest/nogrowth,/area/space)
"bX" = (/obj/effect/decal/cleanable/filth,/obj/item/clothing/head/pumpkinhead,/turf/simulated/floor/outdoors/mud,/area/space)
"bY" = (/obj/effect/decal/remains/mouse,/turf/simulated/floor/outdoors/grass/forest/nogrowth,/area/space)
"bZ" = (/obj/structure/fence{icon_state = "straight"; dir = 4},/turf/simulated/floor/outdoors/grass/forest/nogrowth,/area/space)
"ca" = (/obj/structure/fence{icon_state = "straight"; dir = 4},/turf/simulated/floor/outdoors/mud,/area/space)
"cb" = (/obj/structure/fence/door,/turf/simulated/floor/outdoors/mud,/area/space)
"cc" = (/turf/simulated/floor/water,/area/space)
"cd" = (/obj/structure/flora/rock,/turf/simulated/floor/water,/area/space)
"ce" = (/obj/machinery/light/small,/turf/simulated/floor/water,/area/space)
"cf" = (/obj/effect/wallframe_spawn/basic/red,/turf/simulated/floor/outdoors/grass/forest,/area/space)
"cg" = (/obj/machinery/door/blast/gate{dir = 2; icon_state = "shutter1"; id = "maingate"; name = "main gate"},/turf/simulated/floor/pavement/brick_paving,/area/space)
"ch" = (/obj/machinery/button/remote/driver{id = "maingate"; name = "entrance gate button"; pixel_y = 32},/turf/simulated/floor/outdoors/mud,/area/space)

(1,1,1) = {"
asasasasasasasasasasasasasasasasasasasasasasasasasasasasasasasasasasasasasasasasasasasasasasasasasasasasasasasasasasasasasasasasasasasasasasasasasasasasasasasasasasasasasasasasasas
asauauauauauauauauauauauauauauauauauauauauauauauauauauauauauauauauauauauauauauauauauauauasavavavavavavavavavavavavavavavavavavavavavavavavavavavavavavavavavavavavavavavavavavavavas
asauauauauauawawawawawauauauaxaxaxaxayayayayauauauauauauauauauauauauauauauauawawauauauauasavavavavavavavavavavavavavavavavavavavavavavavavavavavavavavavavavavavavavavavavavavavavaA
asauauauauawawawawawawauauauaxaxaxaxayayayayayayayayauauauauauauauauauauauawawawawawauauasavavavavavavavavavavavavavavavavavavavavavavavavavavavavavavavavavavavavavavavavavavavavaA
asauauauauawawawawawawawauauauaxaxaxayayayayayayayayayaxaxauauauauauauauawawawawaBawawauasavavavavavavavavavavavavavavavavavavavavavavavavavavavavavavavavavavavavavavavavavavavavaA
asauauauauawawawawawawawauauauaxayayayayayayayayayayayaxaxauauauauauauauawaCawawawawaDauasavavavavavavavavavavavavavavavavavavavavavavavavavavavavavavavavavavavavavavavavavavavavaA
asauauauauawawawawawawawauauaxayayayayayayayayayayayayaxaxaxaxaxauauauawawawawawaEawawauasavavavavavavavavavavavavavavavavavavavavavavavavavavavavavavavavavavavavavavavavavavavavaA
asauauauawawawawawawawauauauaxayayayayayayayayayayayayaxaxaxaxaxaxaxauauawawawawawawauauasavavavavavavavavavavavavavavavavavavavavavavavavavavavavavavavavavavavavavavavavavavavavaA
asauauauauauawawawawauauauauaxayayayayayayayayayayayayaxaxaxaxaxaxaxaxauauawawawauauauauasavavavavavavavavavavavavavavavavavavavavavavavavavavavavavavavavavavavavavavavavavavavavaA
asauauauauauauauauawauauauayayayayayayayayayaxaxaxaxaxaxaxaxaxaxaxaxaxazazazawauauauauauasavavavavavavavavavavavavavavavavavavavavavavavavavavavavavavavavavavavavavavavavavavavavaA
asauauaxaxaxauauauazazayayayayayayayayayayazazaxaxaxaxaxaxaxazazazazazazazazazaxaxaxaxauasavavavavavavavavavavavavavavavavavavavavavavavavavavavavavavavavavavavavavavavavavavavavaA
asauauaxaxaxaxazazazazayayayayayayayayazazaxaxaxaxaxazazazazazazazazazazazazaxaxaxaxaxauasavavavavavavavavavavavavavavavavavavavavavavavavavavavavavavavavavavavavavavavavavavavavaA
asauauaxaxaxaxazazazazayayayayayayayayazazazazazazazazazazazazazazaxazazaxaxaxaxaxaxaxauasavavavavavavavavavavavavavavavavavavavavavavavavavavavavavavavavavavavavavavavavavavavavaA
asauauaxaxaxaxaxaxazazayayayayayayayayazazazazazazazazazazazazazazazaxaxaxaxaxaxaxaxaxauasavavavavavavavavavavavavavavavavavavavavavavavavavavavavavavavavavavavavavavavavavavavavaA
asauauaxaxaxaxaxaxazazazazayayayazazazazazazazazazazazazazazayayayazazaxaxaxaxaxaxaxaxauasavavavavavavavavavavavavavavavavavavavavavavavavavavavavavavavavavavavavavavavavavavavavaA
asauauaxaxaxaxaxaxaxazazazayayazazazazazazazazazazazazayayayayayayazazayayaxaxaxaxaxaxauasavavavavavavavavavavavavavavavavavavavavavavavavavavavavavavavavavavavavavavavavavavavavaA
asauauaxaxaxaxaxaxaxazazazazazazazazazazayayayazazazazayayayayayayayayayayaxaxaxaxayayauasavavavavavavavavavavavavavavavavavavavavavavavavavavavavavavavavavavavavavavavavavavavavaA
asauauaxaxaxaxaxaxaxaxazazazazazayayayayayayayayayayayayayayayayayayayayayayayayayayayauasavavavavavavavavavavavavavavavavavavavavavavavavavavavavavavavavavavavavavavavavavavavavaA
asauauaxaxaxaxaxaxaxaxaxaxazazaxaxayayayayayayayayayayayayayayayayayayayayayayayayayayauasavavavavavavavavavavavavavavavavavavavavavavavavavavavavavavavavavavavavavavavavavavavavaA
asauauauaxaxaxaxaxaxaxaxaxazazaxaxayayayayayayayayayayayayayayayayayayayayayayauauayayauasavavavavavavavavavavavavavavavavavavavavavavavavavavavavavavavavavavavavavavavavavavavavaA
asauauauaxaxaxaxaxaxaxaxaxazazaxaxaxaxayayayayayayayayayayayayayayayayayayayayauauayayauasavavavavavavavavavavavavavavavavavavavavavavavavavavavavavavavavavavavavavavavavavavavavaA
asauauauaxaxaxaxaxaxaxaxaxazazaxaxaxaxaxaxaxaxaxayayayayayayayayayayayayayauauauauauauauasavavavavavavavavavavavavavavavavavavavavavavavavavavavavavavavavavavavavavavavavavavavavaA
asauauauauayayaxaxaxaxaxazazazaxaxaxaxaxaxaxaxaxayayayayayayayayayayayayayauauauauauauauasavavavavavavavavavavavavavavavavavavavavavavavavavavavavavavavavavavavavavavavavavavavavaA
asauauayayayayaxaxaxaxaxazazaxaxaxaxaxaxaxaxaxaxaxaxaxaxayayayayayaxaxaxaxauayauauauauauasavavavavavavavavavavavavavavavavavavavavavavavavavavavavavavavavavavavavavavavavavavavavaA
asauauayayayaxaxaxaxaxaxazazaxaxaxaxaxaxaxaxaxaxaxaxaxaxaxaxaxaxaxaxaxaxaxayayauauauauauasavavavavavavavavavavavavavavavavavavavavavavavavavavavavavavavavavavavavavavavavavavavavaA
asauauaFayayazazazaxaxazazazaxaxaxaxaxaxaxaxaxaxaxaxaxaxaxaxaxaxaxaxaxaxaxaxaxayayayauauasavavavavavavavavavavavavavavavavavavavavavavavavavavavavavavavavavavavavavavavavavavavavaA
asauauaFaFaFazazazaxazazazaxaxaxaxaxaxaxaxaxaxaxaxaxaxaxaxaxaxaxaxaxaxaxaxaxaxayayayayauasavavavavavavavavavavavavavavavavavavavavavavavavavavavavavavavavavavavavavavavavavavavavaA
asauauaFaFaFazazazaxazazaxaxaxaxaxaxaxaxaxaxayayayayayayaxaxaxaxaxaxaxaxaxaxaxayayayayauasavavavavavavavavavavavavavavavavavavavavavavavavavavavavavavavavavavavavavavavavavavavavaA
asauauaFaFaFazazazazazazazaxaxaxaxaxaxaxaxaxayayayayayayaxaxaxaxaxaxaxaxaxaxaxayayayayauasavavavavavavavavavavavavavavavavavavavavavavavavavavavavavavavavavavavavavavavavavavavavaA
asauauaFaFaFaFaFazazazazazaxaxaxayayayayayayayayayayayayaxaxaxaxaxaxaxaxaxaxaxaxaxaxaxauasavavavavavavavavavavavavavavavavavavavavavavavavavavavavavavavavavavavavavavavavavavavavaA
asauauaFaFaFaFaFaFaxazazazazazaxayayayayayayayayayayayayayayaxaxaxaxaxaxaxaxaxaxaxaxaxauasavavavavavavavavavavavavavavavavavavavavavavavavavavavavavavavavavavavavavavavavavavavavaA
asauauaFaFaFaFaFaFaFaxazazazazaxayayayayayayayayayayayayayayaxaxaxaxaxaxaxaxaxaxaxaxaxauasavavavavavavavavavavavavavavavavavavavavavavavavavavavavavavavavavavavavavavavavavavavavaA
asauauaFaFaFaFaFaFaFaFaFaFazazaxauauayayayayayayayayayayayayaxaxaxaxaxaxaxaxaxaxaxaxauauasavavavavavavavavavavavavavavavavavavavavavavavavavavavavavavavavavavavavavavavavavavavavaA
asauauauaFaFaFaFaFaFaFaFaFaFauauauauauauayayayayayayayayayayayayayayaxaxaxaxaxauauauauauasaAaAaAaAaAaAaAaAaAaAaAaAaAaAaAaAaAaAaAaAaAaAaAaAaAaAaAaAaAaAaAaAaAaAaAaAaAaAaAaAaAaAaAaAaA
asauauauauauauauauauauauauauauauauauauauauauauauauauauauauauauauauauauauauauauauauauauauasaGaGaGaGaGaGaGaGaGaGaGaGaGaGaGaGaGaGaGaGaGaGaGaGaGaGaGaGaGaGaGaGaGaGaGaGaGaGaGaGaGaGaGaGaA
aaaaaaaaaaaaaaaaaaaaaaaaaaaaaaaaaaaaaaaaaaaaaaaaaaaaaaaaaaaaaaaaaaaaaaaaaaaaaaaaaaaaaaaaaaaGaGaGaGaGaGaGaGaGaGaGaGaGaGaGaGaGaGaGaGaGaGaGaGaGaGaGaGaGaGaGaGaGaGaGaGaGaGaGaGaGaGaGaGaA
aaabababababababababababababababababababababababababababababababababababababababababababaaaGaGaGaGaGaGaGaGaGaGaGaGaGaGaGaGaGaGaGaGaGaGaGaGaGaGaGaGaGaGaGaGaGaGaGaGaGaGaGaGaGaGaGaGaA
aaabababababababababababababababacacadacacacacacacaeacacacacacafacacacabababababababababaaaGaGaGaGaGaGaGaGaGaGaGaGaGaGaGaGaGaGaGaGaGaGaGaGaGaGaGaGaGaGaGaGaGaGaGaGaGaGaGaGaGaGaGaGaA
aaabacacacadababababababababacacacacacacacacacacacacacacacacacacacacacacacacadagacabababaaaGaGaGaGaGaGaGaGaGaGaGaGaGaGaGaGaGaGaGaGaGaGaGaGaGaGaGaGaGaGaGaGaGaGaGaGaGaGaGaGaGaGaGaGaA
aaabahacaiacabababababababacacacacacacacacababababababababacacacacacacacacacacacacabababaaaGaGaGaGaGaGaGaGaGaGaGaGaGaGaGaGaGaGaGaGaGaGaGaGaGaGaGaGaGaGaGaGaGaGaGaGaGaGaGaGaGaGaGaGaA
aaabababacafacababababababacacajacafabababababababababababababababababacakacacacahacababaaaGaGaGaGaGaGaGaGaGaGaGaGaGaGaGaGaGaGaGaGaGaGaGaGaGaGaGaGaGaGaGaGaGaGaGaGaGaGaGaGaGaGaGaGaA
aaababababacacacabababacacacacacacabababababababababacababababababababababacacajacacababaaaGaGaGaGaGaGaGaGaGaGaGaGaGaGaGaGaGaGaGaGaGaGaGaGaGaGaGaGaGaGaGaGaGaGaGaGaGaGaGaGaGaGaGaGaA
aaabababababacacacakabababacacacacababacacacacacacacacacacacacacacadababababacacacacababaaaGaGaGaGaGaGaGaGaGaGaGaGaGaGaGaGaGaGaGaGaGaGaGaGaGaGaGaGaGaGaGaGaGaGaGaGaGaGaGaGaGaGaGaGaA
aaababababababacacaeabababacacalababacacacacacacabababalacacacacacacabababamacafacacababaaaGaGaGaGaGaGaGaGaGaGaGaGaGaGaGaGaGaGaGaGaGaGaGaGaGaGaGaGaGaGaGaGaGaGaGaGaGaGaGaGaGaGaGaGaA
aaababababababacacabababacacacacababacacajacababababababababababacacacacacacacacacacababaaaGaGaGaGaGaGaGaGaGaGaGaGaGaGaGaGaGaGaGaGaGaGaGaGaGaGaGaGaGaGaGaGaGaGaGaGaGaGaGaGaGaGaGaGaA
aaababababababacacabababacacacacababacacacacabababababababababababacacacacacacaeacacababaaaGaGaGaGaGaGaGaGaGaGaGaGaGaGaGaGaGaGaGaGaGaGaGaGaGaGaGaGaGaGaGaGaGaGaGaGaGaGaGaGaGaGaGaGaA
aaababababababacacabababakacacabababacacacacacacabababababababababababababacacacacacababaaaHaHaHaHaHaHaHaHaHaHaNaHaHaHaHaHaHaHaHaHaHaHaHaHaHaHaHaHaHaHaHaHaHaHaHaGaGaGaGaGaGaGaGaGaA
aaababababacacacacababacacacaeababababababacacacacabababababacabababababababababacacadabaaaHaGaGaGaGaHaGaGaGaGaGaGaGaGaGaGaHaGaGaGaGaGaGaGaGaGaGaGaHaGaGaGaGaGaHaGaGaGaGaGaGaGaGaGaA
aaabababadacacacafacacacacacacababababababababacacacacacacacacakababababababababacafacabaaaHaGaOaGaGaHaGaIaIaIaIaIaIaIaIaGaNaIaIaIaIaIaIaIaIaIaIaIaNaGaIaIaIaGaHaGaGaGaGaGaGaGaGaGaA
aaabababacacabababababababacacacabababababababababababababacacacacafacacababababacacacabaaaHaGaGaGaGaNaGaIaIaIaIaIaIaIaIaGaNaIaIaIaIaIaIaIaIaIaIaIaNaGaIaIaIaGaHaGaGaGaGaGaGaGaGaGaA
aaabababacacacababababababacacacacabababababababababababababababacacacacabababacacacacabaaaHbdaGaGaGaHaGaGaGaGaGaGaGaGaGbdaHaGaGaGbdaIaIaIaGaGaGbdaHaGaGaGaGaGaHaGaGaGaGaGaGaGaGaGaA
aaabababacacabababababacacacacacacacacacahacabababacacacabababababababacababababacacacabaaaHaHaHaHaHaHaHaNaHaHaHaHaHbeaHaHaHaGaGaGaGaIaIaIaGaGaGaGaHaHaHbnaHaHaHaGaGaGaGaGaGaGaGaGaA
aaabababacacabababacacacacacababacacacacacacacacacacacacacacacadabababacacahababacacababaaaHboaIbqbsbsaGaGaGbtaGaHaGaGaGbuaHbvbwbxaGaIaIaIbdbxbxaGaHaGaGaGaGbyaHaGaGaGaGaGaGaGaGaGaA
aaababacacacabababacacafacacabababababacacacacacacacacacajacacacabababacacafacacacacababaaaHaIbzaIaGaGaGaGbAaGbBaHbCaIaIbDaHaHaHaHaHbEbEbEaHaHaHaHaHbFaGaGaGaGaHaGaGaGaGaGaGaGaGaGaA
aaababacakababababacacacacacacacadababababababababacacacacacacacacababababacacaladacababaaaHaIaIbGaGaGaGaGaGaGbHaHaGaIaIbIaHbJbfaJbKaIaIaIbKaGbLaKaHaGaGaGaGbMaHaGaGaGaGaGaGaGaGaGaA
aaababacacababababacadacabacacacacababababababababababadafacacababababababacacaeacacababaaaHbNaGaGbAbObIbPaGaGaGaHbvaGaGaGaHaLaMbdaIaIaIaIaIaJaMaLaHaGaGaGbFaGaHaGaGaGaGaGaGaGaGaGaA
aaabacacafacahababacacababababababababababababababababababababababababababacacacacacababaaaHaHaHaHaHaHaHaHaHaHaHaHbQbQbRbQaHbQbRaHaHaHbSaHbTaHbRbQaHbUbUbUaHaHaHaHaHaHaHaHaHaHaHaHaA
aaabaeacamanabababababababacacababababababababababababababababababacacacafacacacacabababaaaHaXaXaXaQaPaRaPbVaPaPaSaTaUaTaTbkbWaSaVbXaXaXaXbXaVaSaTbkaYaTaRaPaZaQbaaXaXaXaXaXaPaQaHaA
aaababacacababababababababacadacacacacacadababababababacahacacacacacacalacacadacababababaaaHaXaXaTaTbbaTaSaTaYaTaXaXaXaXblaXbYaTaTaXaXaWaXaXaTaTaTaTaSaTaXaXaXaTaTaTaXaXaSaTaTaTaHaA
aaababababababababacadababaeacacalacacakacacacacacacacaoacacacacacacacacacacacabababababaaaHbZbZbZbZbZbZbZbZcacacacacacacacacabZbZcacacbcacabZbZbZcacacacacacacabZbZbZbZbZbZbZbZaHaA
aaababababababacacafacababababacacacacacacacacaeaoacacacacacacababacacacacabababababababaabcccccccccccccccccccccccccccccccccccccccbmbmbmbmbmccccccccccccccccccccccccccccccccccccbcaA
aaababababacadacacaoacacababababababababacacacacacacabababababababacacacacabababababababaabccccccccccdccccccccccccccccccccccccccccbmbmbmbmbmcccccccccccccccccccccccccdccccccccccbcaA
aaabababacacacacacacacacakacababababababacacacafacabababababababadaoacacababababababababaabcccccccccccccccccccccccccccccccccccccccbmbmbmbmbmcccccccdccccccccccccccccccccccccccccbcaA
aaabababacacacacajacafacacacahacababababacacacabababababababacaeacacacacababababababababaabccccccccccccccccccccccccccccdcccccccccebmbmbmbmbmceccccccccccccccccccccccccccccccccccbcaA
aaabababaeacafacacacacacacacacacacacacaoacacacabababadacaoacacacacacacabababababababababaabcbpbpcfcfcfcfcfcfcfcfcfcfcfcfcfcfcfbpbpcgcgbpcgcgbpbpcfcfcfcfcfcfcfcfcfcfcfcfcfcfbpbpbcaA
aaabababababacacacacamacabababafacacacacacacacabababacajacapacacacacababababababababababaabcaXaPaPaZaPbaaQaPaPaPaQaPaPaPaPaQbgaTbkaXaXchaXaXbkaSbhaPaPaQaPbaaXaXaRaPaPaXaXaXaXaXbcaA
aaababababababacacacabababababacacacaeacacababababacaoacacacacacababababababababababababaabcaXaXaPaPaPaPaPbabiaZaPaRaQaPaXaPaTaTaTaXaXbraXaXaTaTaPaPaQaPaPaPaPaPaPbaaQaPaXaXaPaPbcaA
aaabababababababababababababababababababababababababaqaratabababababababababababababababaabcaXaXaXaXaPaPaTaTaTaTaTaTaTaXaXaXaTbjaTaXaXaXaXaXaTaTaYaTaTaTaTaTaTaPaPaPaPaPaPaPaPaPbcaA
aaabababababababababababababababababababababababababababababababababababababababababababaabcbcbcbcbcbcbcbcbcbcbcbcbcbcbcbcbcbcbcbcbcbcbcbcbcbcbcbcbcbcbcbcbcbcbcbcbcbcbcbcbcbcbcbcaA
aaaaaaaaaaaaaaaaaaaaaaaaaaaaaaaaaaaaaaaaaaaaaaaaaaaaaaaaaaaaaaaaaaaaaaaaaaaaaaaaaaaaaaaaaaaAaAaAaAaAaAaAaAaAaAaAaAaAaAaAaAaAaAaAaAaAaAaAaAaAaAaAaAaAaAaAaAaAaAaAaAaAaAaAaAaAaAaAaAaA
"}
